NO ./assets/white_wall.xpm
SO ./assets/white_wall_02.xpm
WE ./assets/white_wall_hand.xpm
EA ./assets/white_wall.xpm
F 158,159,57
C 215,255,213

1111111111111111111111111111111111111111
1N00000000000000000000000000000000000001
1000000000000000000000000000000000000001
1000000000100000000000000010000000000001
1000000000100000000000000000000000000001
1000000000111111111100000010000000000001
10000000001111   11110000000000000000001
1000000000111111111100000010000000000001
1000000000100000000000000000000000000001
1000000000100000000000000010000000000001
1000000000100000000000000000000000000001
1000000000100000000000000010000000000001
1000000000100000000000000000000000000001
1000000000100000000000000010000000000001
1000000000000000000000000000000000000001
1000000000000000000000000000000000000001
1000000000000000000000000000000000000001
1111111111111111111111111111111111111111