SO ./assets/white_wall_02.xpm
SO ./assets/white_wall_hand.xpm
WE ./assets/white_wall.xpm
EA ./assets/white_wall.xpm

C 158,159,57

F 215,255,213

1111111111111111111111111111111111111111
1111111111111111111111111111111111111111
1000000000000N00000000000000000000000011
10000000000000000000000000000000000000011111
1000000000100000000000000100000000000011
10000000001000000000000000000000000000011111
1000000000111111111100000010000000000001
10000000001111   11110000000000000000001
1000000000111111111100000010000000000001
1000000000100000000000000000000000000001
1000000000100000000000000010000000000001
1000000000100000000000000000000000000001
1000000000100000000000000010000000000001
1000000000100000000000000000000000000001
1000000000100000000000000010000000000001
1000000000000000000000000000000000000001
1000000000000000000000000000000000000001
1000000000000000000000000000000000000001
1111111111111111111111111111111111111111