NO ./assets/indiana_jones_01.xpm
SO ./assets/indiana_jones_02.xpm
WE ./assets/indiana_jones_03.xpm
EA ./assets/indiana_jones_04.xpm
F 228,95,0
C 104,120,132



                        11111111111
                        10000000001
                        11000000011
11111    1111111111111111110000011
100011  11100000000000000000000001
1001111110111111111111111000000111
100011  1100000000000000001111111
11011    111111111111001101                          11111111
100011111110000000000000001                         1100000011
10001000011011111111111111111111111111111          110000000011
1000000001101               1000000000001         11000000000011
1000100001101               1000000000001111111111100000000000011
100011111110111111          1000000000000000000000000000000000001
100011000000000001          1000000000001111111111100000000000011
100011000000000001          1000000000001         11000000000011
10001100000000000111111111111000000000001          110000000011
10001100000000000000000000000000011111111           1100000011
10001100000000000000000000000000011111111            10000001
10001100000000000000000000000000011111111            10000001
10001100000000000000000000000000011111111            10000001
10001100000000000000000000000000011111111            10000001
10001100000000000000000000000000011111111            10000001
10001100000000000000000000000000011111111            10000001
10001100000000000000000000000000011111111            10000001
10001100000000000000000000000000011111111            10000001
10001100000000000000000000000000011111111            10000001
10001100000000000000000000000000011111111            10000001
10001100000000000000000000000000011111111            10000001
10001100000000000000000000000000011111111            10000001
10001100000000000000000000000000011111111            10000001
10001100000000000000000000000000011111111            10000001
10001100000000000000000000000000011111111            10000001
10001100000000000000000000000000011111111            10000001
10001100000000000000000000000000011111111            10000001
10001100000000000000000000000000011111111            10000001
10001100000000000000000000000000011111111            10000001
10001100000000000000000000000000011111111            10000001
10001100000000000000000000000000011111111            10000001
10001100000000000000000000000000011111111            10000001
10001100000000000000000000000000011111111            10000001
10001100000000000000000000000000011111111            10000001
10001100000000000000000000000000011111111            10000001
10001100000000000000000000000000011111111            10000001
10001100000000000000000000000000011111111            10000001
10001100000000000000000000000000011111111            10000001
10001100000000000000000000000000011111111            10000001
10001100000000000000000000000000011111111            10000001
10001100000000000000000000000000011111111            10000001
10001100000000000000000000000000011111111            10000001
10001100000000000000000000000000011111111            10000001
10001100000000000000000000000000011111111            10000001
10001100000000000000000000000000011111111            10000001
10001100000000000000000000000000011111111            10000001
10001100000000000000000000000000011111111            10000001
10001100000000000000000000000000011111111            10000001
10001100000000000000000000000000011111111            10000001
10001100000000000000000000000000011111111            10000001
10001100000000000000000000000000011111111            10000001
10001100000000000000000000000000011111111            10000001
10001100000000000000000000000000011111111            10000001
10001100000000000000000000000000011111111            10000001
10001100000000000000000000000000011111111            10000001
10001100000000000000000000000000011111111            10000001
10001100000000000000000000000000011111111            10000001
10001100000000000000000000000000011111111            10000001
10001100000000000000000000000000011111111            10000001
10001100000000000000000000000000011111111            10000001
10001100000000000000000000000000011111111            10000001
10001100000000000000000000000000011111111            10000001
100011N0000000000000000000000000011111111            10000001
1000110000000000000000000000000001                   10000001
1111111111111111111111111111111111                   11111111