NO ./assets/indiana_jones_01.xpm
SO ./assets/indiana_jones_02.xpm
WE ./assets/indiana_jones_03.xpm
EA ./assets/indiana_jones_04.xpm
F 22,100,1
C 225,30,1


        1111111111111111111111111
        1000000000110000000000001
        1011000001110000000000001
        1001000000000000000000001
111111111011000001110000000000001
100000000110000011101111111111111
11110111111111011100000010001
11110111111111011101010110001
11000000110101011100010010001
10000000000000011000000100011
10S00010000000001101010010001
11000001110101011111011110011
11110111 1110101 101111010001
11111111 1111111 111111111111