NO ./assets/indiana_jones_01.xpm
SO ./assets/indiana_jones_02.xpm
WE ./assets/indiana_jones_03.xpm
EA ./assets/indiana_jones_04.xpm
F 228,95,0
C 104,120,132

1111111111111111111111111111111111111111
1000000000000000000000000000000000000001
1000000000000000000000000000000000000001
1000000000100000000000000010000000000001
1000000000100000000000000000000000000001
100000000011111111110000001000000N000001
1000000000111111111110000000000000N00011
1000000000111111111100000010000000000001
1000000000100000000000000000000000000001
1000000000100000000000000010000000000001
1000000000100000000000000000000000000001
1000000000100000000000000010000000000001
1000000000100000000000000000000000000001
1000000000100000000000000010000000000001
1000000000000000000000000000000000000001
1000000000000000000000000000000000000001
1000000000000000000000000000000000000001
1111111111111111111111111111111111111111