NO ./assets/indiana_jones_01.xpm
SO ./assets/indiana_jones_02.xpm
WE ./assets/indiana_jones_03.xpm
EA ./assets/indiana_jones_04.xpm
F 228,95,0
C 104,120,132

11111111111111110
10000000000000001
10000000000000001
10000000000000001
10000000000000001
10000000000000001
10000000N00000001
10000000000000001
10000000000000001
10000000000000001
10000000000000001
10000000000000001
11111111111111111