NO assets/images/redbrick.xpm
SO assets/images/grenbrick.xpm
EA assets/images/bluebrick.xpm
WE assets/images/yellowbrick.xpm
C 104,120,132
F 228,95,0






1111111111111111111111111111111111111111
1000000000000000000000000000000000000001
1000000000000000000000000000000000000001
1000000000100000000000000010000000000001
1000000000100000000000000010000000000001
1000000000111111111100000010000000000001
10000000001       1 00000010000000000001
1000000000111111111 00000010000000000001
10000000001000000N0000000010000000000001
1000000000100000000000000010000000000001
1000000000100000000000000010000000000001
1000000000100000000000000010000000000001
1000000000100000000000000010000000000001
1000000000100000000000000010000000000001
1000000000000000000000000000000000000001
1000000000000000000000000000000000000001
1000000000000000000000000000000000000001
1111111111111111111111111111111111111111
