NO ./path_to_the_north_texture
SO ./path_to_the_south_texture
WE ./path_to_the_west_texture
EA ./path_to_the_east_texture

F 220,100,0
C 225,30,0


                        11111111111
                        10000000001
                        11000000011
11111    111111111111111111000001
10001    100000000000000000000001
100111111011111111111111100000011
10001    100000000000000001111111
11011    111111111111001101                           111111
100011111110000000000000001                          10000001
10001000011011111111111111111111111111111           1000000001
1000000001101               1000000000001          100000000001
1000100001101               100000000000111111111110000000000001
100011111110111111          1000000000000000000000000000000000001
100011000000000001          100000000000111111111110000000000001
100011000000000001          1000000000001          100000000001
10001100000000000111111111111000000000001           1000000001
10001100000000000000000000000000011111111            10000001
10001100000000000000000000000000011111111            10000001
10001100000000000000000000000000011111111            10000001
10001100000000000000000000000000011111111            10000001
10001100000000000000000000000000011111111            10000001
10001100000000000000000000000000011111111            10000001
10001100000000000000000000000000011111111            10000001
10001100000000000000000000000000011111111            10000001
10001100000000000000000000000000011111111            10000001
10001100000000000000000000000000011111111            10000001
10001100000000000000000000000000011111111            10000001
10001100000000000000000000000000011111111            10000001
10001100000000000000000000000000011111111            10000001
10001100000000000000000000000000011111111            10000001
10001100000000000000000000000000011111111            10000001
10001100000000000000000000000000011111111            10000001
10001100000000000000000000000000011111111            10000001
10001100000000000000000000000000011111111            10000001
10001100000000000000000000000000011111111            10000001
10001100000000000000000000000000011111111            10000001
10001100000000000000000000000000011111111            10000001
10001100000000000000000000000000011111111            10000001
10001100000000000000000000000000011111111            10000001
10001100000000000000000000000000011111111            10000001
10001100000000000000000000000000011111111            10000001
10001100000000000000000000000000011111111            10000001
10001100000000000000000000000000011111111            10000001
10001100000000000000000000000000011111111            10000001
10001100000000000000000000000000011111111            10000001
10001100000000000000000000000000011111111            10000001
10001100000000000000000000000000011111111            10000001
10001100000000000000000000000000011111111            10000001
10001100000000000000000000000000011111111            10000001
10001100000000000000000000000000011111111            10000001
10001100000000000000000000000000011111111            10000001
10001100000000000000000000000000011111111            10000001
10001100000000000000000000000000011111111            10000001
10001100000000000000000000000000011111111            10000001
10001100000000000000000000000000011111111            10000001
10001100000000000000000000000000011111111            10000001
10001100000000000000000000000000011111111            10000001
10001100000000000000000000000000011111111            10000001
10001100000000000000000000000000011111111            10000001
10001100000000000000000000000000011111111            10000001
10001100000000000000000000000000011111111            10000001
10001100000000000000000000000000011111111            10000001
10001100000000000000000000000000011111111            10000001
10001100000000000000000000000000011111111            10000001
10001100000000000000000000000000011111111            10000001
10001100000000000000000000000000011111111            10000001
10001100000000000000000000000000011111111            10000001
10001100000000000000000000000000011111111            10000001
10001100000000000000000000000000011111111            10000001
100011N0000000000000000000000000011111111            10000001
10001100000000000000000000000000011111111            10000001
111111111111111111111111111111111                     111111