NO textures/first_brick_layer.png
SO textures/second_brick_layer.png
EA textures/third_brick_layer.png
WE textures/fourth_brick_layer.png

F 12,123,3
C 40,40,40

1111
1011011
1001001
1N00011
111111
111