NO ./assets/indiana_jones_01.xpm
SO ./assets/indiana_jones_02.xpm
WE ./assets/indiana_jones_03.xpm
EA ./assets/indiana_jones_04.xpm
C 104,120,132
F 228,95,0

11111111111111111111111
10000000000100000000001
10111011110101111011101
10111011110101111011101
10000000000000000000001
10111010111111101011101
10000010000100001000001
11111011110101111011111
11111010000000001011111
11111000111011100011111
11111010111E11101011111
11111010000000001011111
11111010111111101011111
10000000000100000000001
10111011110101111011101
10001000000000000010001
11101010111111101010111
10000010000100001000001
10111111110101111111101
10000000000000000000001
11111111111111111111111